....................ooo.......
.....H.A.W.........ooo........
..................ooo.........
...H.A.W.........ooo..........
................ooo...........
.H.A.W.........ooo............
..............ooo.............
.A.W.........ooo..............
............ooo...............
.W.........ooo................
..........ooo.......a.........
.........ooo..................
........ooo.......w...........
.......ooo..............o.....
......ooo..............oo.....
......oo..............ooo.....
......o..............ooo......
....................ooo.......
............W......ooo........
..................ooo.........
..........A......ooo........w.
................ooo...........
...............ooo........w.a.
..............ooo.............
.............ooo........w.a.h.
............ooo...............
...........ooo........w.a.h...
..........ooo.................
.........ooo........w.a.h.....
........ooo...................
